XXXXXXXXXXXXXXXXX
X   FFF X       X
X X XX X X X XX X
X X X* X     X  X
X   X XXXX XXX XX
  X     XX  X   X
 XXX XX XXX X X X
  X         X X X
X   X X XXX FFF X
X X     XXX XXX X
X X XXX   X XXX X
X  HXXX X X   X X
XXX*FXXFX   X   X